NO           textures/texture.xpm



SO textures/texture.xpm


EAtextures/texture.xpm

WE textures/texture.xpm
F 0,0,0
C 0,0,0


11111
0N0
111
