NO textures/Northern_texture.xpm



SO textures/southern_texture.xpm



EA textures/eastern_texture.xpm

WE textures/western_texture.xpm
F 0,0,0
C 0,0,0

111111111111111
100000001000001
100000001000001
10000N000000001
100000000001001
100000000000001
100000000000001
100001000000001
100100000000001
100000000000001
100000000000001
100000000000001
100000000000001
100000000000001
100000000000001
100000000010001
100000000000001
100000000000001
100000000000001
100000000000001
100000000000001
100000000000001
100000000000001
100000000000001
100000000000001
100000000000001
100000000000001
100000000000001
100000000000001
100000000000001
100000000000001
100000000000001
100000000000001
100000000000001
100000000000001
100000000000001
100000000000001
100000000000001
100000000000001
100000000000001
100000000000001
100000000000001
100000000000001
100000000000001
100000000000001
100000000000001
100000000000001
100000000000001
100000000000001
100000000000001
100000000000001
100000000000001
100000000000001
100000000000001
100000000000001
100000000000001
100000000000001
100000000000001
100000000000001
100000000000001
100000000000001
100000000000001
100000000000001
100000000000001
100000000000001
100000000000001
100000000000001
100000000000001
100000000000001
100000000000001
100000000000001
100000000000001
100000000000001
100000000000001
100000000000001
111111111111111
