NO textures/Northern_texture.xpm



SO textures/southern_texture.xpm



EA textures/eastern_texture.xpm

WE textures/western_texture.xpm
F 0,0,0
C 0,0,0























111111
1S0001
111111                  
