NO textures/Northern_texture.xpm



SO textures/southern_texture.xpm



EA textures/eastern_texture.xpm

WE textures/western_texture.xpm
F 0,0,0
C 0,0,0


1111111111111
1000000 1 N1
1111111111111
