NO                                  textures/texture.xpm
SOtextures/texture.xpm
WEtextures/texture.xpm
EAtextures/texture.xpm
F45,45,45
C24,68,44

111111111111111
100000001000001
100000001000001
10000N000000001
100000000001001
100000000000001
111111111111111
