NO                                  textures/viego1.xpm
SOtextures/aatrox1.xpm
WEtextures/jhin.xpm
EAtextures/classic.xpm
F45,45,45
C24,68,44

111111111111111
100000000000001
100000000000001
100000E00000001
100000000001001
100000000000001
111111111111111
