NO                                  textures/Planks1.xpm
SOtextures/Bricks1.xpm
WEtextures/Bricks2.xpm
EAtextures/Bricks3.xpm
F 255,0,0
C 0,0,210

111111111111111
100000000000001   1111111
100000000000001   1000001
100000N100000011111000001
1000000000000000000000001111
1000000000000011010000000001
1111111111111111010000000001
1111111111111111011111111111
1111111111000000000000000001
1111111111111111111111111111
